[
    {
        "level": 1,
        "map": [
          [ "0x0000", "0x0108", "0x0000", "0x0000", "0x0000", "0x0000", "0x0000", "0x0000", "0x0000", "0x0400" ],
          [ "0x0000", "0x0008", "0x0000", "0x0000", "0x0000", "0x0000", "0x0000", "0x0000", "0x0000", "0x0000" ],
          [ "0x0000", "0x0008", "0x0000", "0x0000", "0x0000", "0x0000", "0x0000", "0x0000", "0x0000", "0x0000" ],
          [ "0x0000", "0x0008", "0x0000", "0x0000", "0x0000", "0x0000", "0x0000", "0x0000", "0x0000", "0x0000" ],
          [ "0x0000", "0x0008", "0x0000", "0x0000", "0x0020", "0x0000", "0x0000", "0x0000", "0x0000", "0x0000" ],
          [ "0x0000", "0x0008", "0x0000", "0x0000", "0x0000", "0x0000", "0x0000", "0x0000", "0x0000", "0x0000" ],
          [ "0x0008", "0x0008", "0x0000", "0x0000", "0x0000", "0x0000", "0x0000", "0x0000", "0x0000", "0x0000" ],
          [ "0x0008", "0x0008", "0x0000", "0x0000", "0x0000", "0x0000", "0x0000", "0x0000", "0x0000", "0x0000" ],
          [ "0x0018", "0x0000", "0x0000", "0x0000", "0x0000", "0x0000", "0x0000", "0x0001", "0x0001", "0x0001" ],
          [ "0x0008", "0x0000", "0x0200", "0x0000", "0x0000", "0x0000", "0x0000", "0x0000", "0x0000", "0x0300" ]
        ],
        "targets": [ 1, 2, 3, 4, 5, 6 ]
    },
    {
        "level": 10,
        "map": [
          [ "0x0000", "0x0000", "0x0000", "0x0000", "0x0000", "0x0000", "0x0000", "0x0000", "0x0000", "0x0000" ],
          [ "0x0000", "0x0000", "0x0000", "0x0000", "0x0000", "0x0000", "0x0000", "0x0000", "0x0000", "0x0000" ],
          [ "0x0000", "0x0000", "0x0000", "0x0000", "0x0000", "0x0000", "0x0000", "0x0000", "0x0000", "0x0000" ],
          [ "0x0000", "0x0000", "0x0000", "0x0000", "0x0000", "0x0000", "0x0000", "0x0000", "0x0000", "0x0000" ],
          [ "0x0000", "0x0000", "0x0000", "0x0000", "0x0000", "0x0000", "0x0000", "0x0000", "0x0000", "0x0000" ],
          [ "0x0000", "0x0000", "0x0000", "0x0000", "0x0000", "0x0000", "0x0000", "0x0000", "0x0000", "0x0000" ],
          [ "0x0000", "0x0000", "0x0000", "0x0000", "0x0000", "0x0000", "0x0000", "0x0000", "0x0000", "0x0000" ],
          [ "0x0000", "0x0000", "0x0000", "0x0000", "0x0000", "0x0000", "0x0000", "0x0000", "0x0000", "0x0000" ],
          [ "0x0000", "0x0000", "0x0000", "0x0000", "0x0000", "0x0000", "0x0000", "0x0000", "0x0000", "0x0000" ],
          [ "0x0000", "0x0000", "0x0000", "0x0000", "0x0000", "0x0000", "0x0000", "0x0000", "0x0000", "0x0000" ]
        ]
    },
    {
        "level": 11,
        "map": [
          [ "0x0000", "0x0300", "0x0000", "0x0000", "0x0000", "0x0000", "0x0200", "0x0000", "0x0000", "0x0600" ],
          [ "0x0000", "0x0000", "0x0000", "0x0000", "0x0000", "0x0000", "0x0000", "0x0000", "0x0000", "0x0000" ],
          [ "0x0000", "0x0000", "0x0000", "0x0000", "0x0000", "0x0000", "0x0000", "0x0000", "0x0000", "0x0000" ],
          [ "0x0000", "0x0000", "0x0000", "0x0000", "0x0000", "0x0000", "0x0000", "0x0000", "0x0000", "0x0000" ],
          [ "0x0000", "0x0000", "0x0000", "0x0000", "0x0000", "0x0000", "0x0000", "0x0000", "0x0400", "0x0000" ],
          [ "0x0500", "0x0000", "0x0000", "0x0000", "0x0000", "0x0000", "0x0000", "0x0000", "0x0000", "0x0000" ],
          [ "0x0000", "0x0000", "0x0000", "0x0000", "0x0800", "0x0900", "0x0000", "0x0000", "0x0000", "0x0000" ],
          [ "0x0000", "0x0000", "0x0000", "0x0000", "0x0000", "0x0000", "0x0000", "0x0000", "0x0000", "0x0000" ],
          [ "0x0000", "0x0000", "0x0000", "0x0000", "0x0000", "0x0000", "0x0000", "0x0000", "0x0000", "0x0020" ],
          [ "0x0000", "0x0000", "0x0700", "0x0100", "0x0000", "0x0000", "0x0000", "0x0000", "0x0000", "0x0A00" ]
        ],
        "targets": [ 1, 2, 4, 8, 16, 32, 64, 65, 66, 99 ]
    }
]
